'...........'
'.#.#.#.#.#.'
'...........'
'.#B#.#.#.#.'
'..B........'
'.#.#.#.#.#.'
'...........'
'.#.#.#.#.#.'
'...........'
'.#.#.#.#.#.'
'...........'