'...........'
'.#.#.#.#.#.'
'...........'
'.#*#.#.#.#.'
'..*........'
'.#.#.#.#.#.'
'...........'
'.#.#.#.#.#.'
'...........'
'.#.#.#.#.#.'
'...........'